......................
......................
......................
..................O...
......................
......................
.....###########......
.....###########......
.....###########......
.............###......
.............###......
.............###......
.............###......
.............###......
......................
......................
......................
......................
......................
......................
......................
X.....................