X..............
...............
.......efvsw...
.Å....##.......
..P...##.......
...:.....21134.
..............O