...#O............................................
.X.#.............................................
...#.............................................
...######################........................
...#.............................................
...#.............................................
...#.............................................
...#.............................................
...#.............................................
...#.............................................
...#.............................................
...#.............................................
...#.............................................
...#.............................................
...#.............................................
...#............######################...........
...#............######################...........
...#............######################...........
...#............######################...........
...#............######################...........
...#............######################...........
...#............######################...........
...#............######################...........
...#............######################...........
...#............######################...........
...#............######################...........
...#............######################...........
...#............######################...........
...#............######################...........
...#............######################...........
...#............######################...........
...#............######################...........
...#............######################...........
...#.............................................
...#.............................................
...#.............................................
...#.............................................
...#.............................................
...####################..........................
...#.............................................
...#.............................................
...#.............................................
...#.............................................
...#.............................................
...#.............................................
...#.............................................
...#.............................................
...#.............................................
.................................................
.................................................