X..................
...................
################...
...................
........#.#########
........#.#........
........#.#.#.#####
........### #.#####
............#......
............#..#...
............#..#...
............#..#...
............#..#...
............#..#...
............#..#...
............#..#...
............#..#...
............#..#...
............#..#...
............#..#..O